.........................
.X.....................X.
.X.....X...X.X...X.....X.
.X....X.X..X.X..X.X....X.
.XX........X.X........XX.
.........................
..X....XX.......XX....X..
.X..........X..........X.
........X.......X........
.........X.....X.........
...X.....XX...XX.....X...
...XX...............XX...
...X.................X...
.........................
.........XX...XX.........
X.........X...X.........X
X....XX...........XX....X
.X.....................X.
.XX.......X...X.......XX.
..X........X.X........X..
.....X.............X.....
.....X.............X.....
.......XX.......XX.......
.....X.............X.....
.........................
3 2
10 1
12 1
16 1
3 22
10 23
12 23
16 23
20
7 7 3 0 12
7 17 3 0 12
11 5 4 0 15
11 19 4 0 15
12 12 10 0 20
23 8 4 0 10
23 16 4 0 10
18 12 7 18 20
9 8 2 25 50
9 16 2 25 50
11 8 5 30 20
11 16 5 30 20
9 12 10 45 25
3 12 8 50 25
12 4 2 60 25
12 20 2 60 25
15 12 12 78 20
13 6 6 85 15
13 18 6 85 15
14 12 9 90 10
