.........................
.X..................X....
...........X..X..........
......................X..
..........X.............X
.X..X......X.............
..........X..............
.............X..X........
...................X....X
X.........X......X.......
..........X..............
.........................
.......X.................
.........................
..........X..............
X.........X......X.......
...................X....X
.............X..X........
..........X..............
.X..X......X.............
..........X.............X
......................X..
...........X..X..........
.X..................X....
.........................
4 11
6 19
10 1
1 18
20 11
18 19
14 1
23 18
30
12 2 11 4 4
12 17 6 7 7
17 17 10 12 7
7 17 10 12 7
12 12 12 14 11
20 15 9 17 10
4 15 9 17 10
9 11 9 22 6
11 6 10 23 6
21 19 9 30 12
7 20 12 32 9
11 5 4 35 3
6 4 4 38 11
2 15 8 42 11
11 4 12 44 4
15 9 6 47 3
2 2 12 48 8
23 18 6 55 7
17 8 3 63 6
17 12 3 64 7
21 9 8 65 11
6 17 6 70 3
11 3 8 71 6
6 12 10 75 9
7 0 10 81 12
22 10 6 84 7
22 1 3 89 9
11 13 11 93 8
8 2 4 94 12
12 21 11 96 3
