.........................
.........................
.....XXX.......X.....XX..
.....X.X.......XX....XX..
.....XXX........X........
.........................
........XXXXXXX..........
.........................
.............X....X......
.............XX..XX......
.............XX..XX......
.............X....X......
...XXXXX...............XX
...X.........X...........
...X........X............
.........................
.........................
.......................X.
....X....................
.........................
.........................
.........................
.........................
.......X.................
......................X..
1 3
1 6
1 10
6 20
24 24
24 0
7 3
11 3
4
9 15 42 3 100
14 5 7 0 10
20 20 10 5 70
24 15 8 0 5
6
3 10 15 20 27 42
SUD
